#############
#     # # # #
# ### # # # #
# # #   #   #
### # ##### #
# #     #   #
# ##### # # #
# #       # #
# # # ##### #
#   #       #
#############