###################
#     # # #       #
# ### # # ### # # #
# # #   #   # # # #
### # ##### # ### #
# #     #   #     #
# ##### # # # ### #
# #       # # # # #
# # # ##### # # # #
#   #             #
###################